15 15
###############
#1            #
#             #
#             #
#             #
#             #
#             #
#             #
#             #
#             #
#             #
#             #
#             #
#            2#
###############
15 15
###############
##            #
#1            #
#             #
#             #
#             #
#             #
#             #
#             #
#             #
#             #
#             #
#            2#
#            ##
###############
15 15
###############
##            #
##            #
#1            #
#             #
#             #
#             #
#             #
#             #
#             #
#             #
#             #
#           2##
#            ##
###############
15 15
###############
##            #
##            #
##            #
#1            #
#             #
#             #
#             #
#             #
#             #
#             #
#             #
#          2###
#            ##
###############
15 15
###############
##            #
##            #
##            #
##            #
#1            #
#             #
#             #
#             #
#             #
#             #
#          2  #
#          ####
#            ##
###############
15 15
###############
##            #
##            #
##            #
##            #
##1           #
#             #
#             #
#             #
#             #
#             #
#         2#  #
#          ####
#            ##
###############
15 15
###############
##            #
##            #
##            #
##            #
###1          #
#             #
#             #
#             #
#             #
#         2   #
#         ##  #
#          ####
#            ##
###############
15 15
###############
##            #
##            #
##            #
##            #
####          #
#  1          #
#             #
#             #
#             #
#        2#   #
#         ##  #
#          ####
#            ##
###############
15 15
###############
##            #
##            #
##            #
##            #
####          #
#  #1         #
#             #
#             #
#             #
#       2##   #
#         ##  #
#          ####
#            ##
###############
15 15
###############
##            #
##            #
##            #
##            #
####          #
#  ##1        #
#             #
#             #
#       2     #
#       ###   #
#         ##  #
#          ####
#            ##
###############
15 15
###############
##            #
##            #
##            #
##            #
#### 1        #
#  ###        #
#             #
#       2     #
#       #     #
#       ###   #
#         ##  #
#          ####
#            ##
###############
15 15
###############
##            #
##            #
##            #
##            #
#### #1       #
#  ###        #
#       2     #
#       #     #
#       #     #
#       ###   #
#         ##  #
#          ####
#            ##
###############
15 15
###############
##            #
##            #
##            #
##            #
#### ##1      #
#  ###  2     #
#       #     #
#       #     #
#       #     #
#       ###   #
#         ##  #
#          ####
#            ##
###############
15 15
###############
##            #
##            #
##            #
##     1      #
#### ###2     #
#  ###  #     #
#       #     #
#       #     #
#       #     #
#       ###   #
#         ##  #
#          ####
#            ##
###############
15 15
###############
##            #
##            #
##     1      #
##     #      #
#### ####2    #
#  ###  #     #
#       #     #
#       #     #
#       #     #
#       ###   #
#         ##  #
#          ####
#            ##
###############
15 15
###############
##            #
##            #
##     #1     #
##     # 2    #
#### #####    #
#  ###  #     #
#       #     #
#       #     #
#       #     #
#       ###   #
#         ##  #
#          ####
#            ##
###############
15 15
###############
##            #
##            #
##     ##1    #
##     # #2   #
#### #####    #
#  ###  #     #
#       #     #
#       #     #
#       #     #
#       ###   #
#         ##  #
#          ####
#            ##
###############
15 15
###############
##            #
##            #
##     ###1   #
##     # ##2  #
#### #####    #
#  ###  #     #
#       #     #
#       #     #
#       #     #
#       ###   #
#         ##  #
#          ####
#            ##
###############
Players collided. Draw!
