15 15
###############
##            #
#1            #
#             #
#             #
#             #
#             #
#             #
#             #
#             #
#             #
#             #
#            2#
#            ##
###############
