25 24
#########################
#       #######         #
# #######     #         #
###############         #
## ######################
##  ################  ###
##  ################ ## #
##  ##################  #
##  ################### #
##  ################### #
##  ##########  ####### #
#1  ################### #
#2##################### #
# ##################### #
# ################## ## #
# ################## #  #
# ###############  ###  #
# ############### ####  #
# # ##################  #
# #######################
# #######################
# ######               ##
#      ##################
#########################
