5 5
#####
#1  #
#   #
#  2#
#####